1111111111111
10C10000000E1
1000001111111
100C0000PC001
1111111111111