1111111111111111111111111111
1000000000000000000000000011
100CCCCCCCCCCCC0111010111111
1000000000000000100010101CE1
1000101010101010101010000P11
1111111111111111111111111111