111111111111111111111111111111111
1C1E10000000000000000000000000001
10000000000000000000000000C000001
10000000000000000000000000C000001
1001110000C0100000100010011111001
100100100010100000100010000010001
100100010010100P0010C010000100001
100100100010100000100010001000001
100111000010111100011100011111001
100000000000000000000000000000001
100000000000000000000000000000001
100000000000000000000000000000001
111111111111111111111111111111111